XXXXXXXXXXXXXXXXXXXX
X                  X
X        E         X
X       XXX        X
X          X       X
X         X        X
X        X E       X
X       XXXX       X
X   E              X
X                  X
X             P    X
XXXXXXXXXXXXXXXXXXXX
XXXXXXXXXXXXXXXXXXXX
