XXXXXXXXXXXXXXXXXXXX
X                  X
X                  X
X       XXXX       X
X                  X
X                  X
X                  X
X                  X
XXXXX              X
X                  X
X                  X
XXXXXXXXXXXXXXXXXXXX
XXXXXXXXXXXXXXXXXXXX
