XXXXXXXXXXXXXXXXXXXXXXXXXXXXXXXXXXXXXXXX
X                  
X         P   S    
        XXXXXXXXXXXX
                   X
X                  X
X                  X
X  E               X
XXXXX              X
X                  X
X  E     E      E  X
XXXXXXXXXXXXXXXXXXXXXXXXXXXXXXXXXXXXXXXX
XXXXXXXXXXXXXXXXXXXXXXXXXXXXXXXXXXXXXXXX
XXXXXXXXXXXXXXXXXXXXXXXXXXXXXXXXXXXXXXXX
