X                                                                                                                                                                                                                    X
X                                                                                                                                                                                                                    X
X                                                                                                                                                                                                                    X
X                                                                                                                                                                                                                    X
X                      ?                                               XXXXXXXX   XXX?              ?           XXX    X??X                                                        XX                                X
X                                                                                                                                                                                 XXX                                X
X                                                                                                                                                                                XXXX                                X
X                                                                                                                                                                               XXXXX             XXX                X
X                ?   X?X?X                     PP                   X?X              X     XX    ?  ?  ?     X          XX      X  X          XX  X            XX?X            XXXXXX             XXX                X
X                                      PP      PP                                                                              XX  XX        XXX  XX                          XXXXXXX            XXXXX               X
X                            PP        PP      PP                                                                             XXX  XXX      XXXX  XXX     PP              PP XXXXXXXX            XXXXX               X
X                            PP        PP      PP                                                                            XXXX  XXXX    XXXXX  XXXX    PP              PPXXXXXXXXX        X   XXXXX               X
XXXXXXXXXXXXXXXXXXXXXXXXXXXXXXXXXXXXXXXXXXXXXXXXXXXXXXXXXXX  XXXXXXXXXXXXXXXX   XXXXXXXXXXXXXXXXXXXXXXXXXXXXXXXXXXXXXXXXXXXXXXXXXXXXXXXXXXXXXXXX  XXXXXXXXXXXXXXXXXXXXXXXXXXXXXXXXXXXXXXXXXXXXXXXXXXXXXXXXXXXXXXXXXXXX
XXXXXXXXXXXXXXXXXXXXXXXXXXXXXXXXXXXXXXXXXXXXXXXXXXXXXXXXXXX  XXXXXXXXXXXXXXXX   XXXXXXXXXXXXXXXXXXXXXXXXXXXXXXXXXXXXXXXXXXXXXXXXXXXXXXXXXXXXXXXX  XXXXXXXXXXXXXXXXXXXXXXXXXXXXXXXXXXXXXXXXXXXXXXXXXXXXXXXXXXXXXXXXXXXX
XXXXXXXXXXXXXXXXXXXXXXXXXXXXXXXXXXXXXXXXXXXXXXXXXXXXXXXXXXX  XXXXXXXXXXXXXXXX   XXXXXXXXXXXXXXXXXXXXXXXXXXXXXXXXXXXXXXXXXXXXXXXXXXXXXXXXXXXXXXXX  XXXXXXXXXXXXXXXXXXXXXXXXXXXXXXXXXXXXXXXXXXXXXXXXXXXXXXXXXXXXXXXXXXXX
XXXXXXXXXXXXXXXXXXXXXXXXXXXXXXXXXXXXXXXXXXXXXXXXXXXXXXXXXXX  XXXXXXXXXXXXXXXX   XXXXXXXXXXXXXXXXXXXXXXXXXXXXXXXXXXXXXXXXXXXXXXXXXXXXXXXXXXXXXXXX  XXXXXXXXXXXXXXXXXXXXXXXXXXXXXXXXXXXXXXXXXXXXXXXXXXXXXXXXXXXXXXXXXXXX